WWWWWWWWWWWWWWWWWWWWWWWWWWWWWWWWWWWWWWWWWWWWWWWWWWWWWWWWWWWWWWWWWWWWWWWWWWWWWWWWWWWWWWWW
W                                                                                      W
W              K                                                                       W
W                                                                                      W
W                                                                                      W
W                                                                                      W
W                                                                                      W
W                                                                                      W
W                                                                                      W
W                                                                                      W
W                                                                                      W
W                                                                                      W
W                                                                                      W
W                                                                                      W
W                                                                                      W
W                     B                                                                W
W                                                                                      W
W                                                                                      W
W                                                                                      W
W                                                                                      W
W                                                                                      W
W                                                                                      W
W                                                                                      W
W      M                                                                               W
W                                                                                      W
W                                                                                      W
W                                                                                      W
W                                                                                      W
W                                                                                      W
W                                                                                      W
W                                                                                      W
WWWWWWWWWWWWWWWWWWWWWWWWWWWWWWWWWWWWWWWWWWWWWWWWWWWWWWWWWWWWWWWWWWWWWWWWWWWWWWWWWWWWWWWW
