WWWWWWWWWWWWWWWWWWWWWWWWWWWWWWWWWWWWWWWWWWWWWWW
W                                             W
W              K                              W
W                                             W
W                                             W
W                                             W
W                                             W
W                                             W
W                       B                     W
W       M                         G           W
WWWWWWWWWWWWWWWWWWWWWWWWWWWWWWWWWWWWWWWWWWWWWWW