WWWWWWWWWWWWWWWWWWWWWWWWWWWWWWWWWWWWWWWWWWWWWWWWWWWWWWWWWWWWWWWWWWWWWWWWWWWWWWW
W                                                                             W
W              K                                                              W
W                                                                             W
W B                                                                           W
W                                                                             W
W                                                                             W
W                                                                             W
W                                                                             W
W                                                                          B  W
W                                                                             W
W                                                                             W
W                                                                             W
W                                                                             W
W                                                                             W
W                                                                             W
W                                                                             W
W                                                                             W
W                                                                             W
W                                                                             W
W                                                                             W
W                                                                             W
W                                                                             W
W  X   M                                                    G              X  W
W                                                                             W
W                                                                             W
W                                                                             W
W                                                                             W
W                                                                             W
W                                                                             W
W                                                    K                       DW
WWWWWWWWWWWWWWWWWWWWWWWWWWWWWWWWWWWWWWWWWWWWWWWWWWWWWWWWWWWWWWWWWWWWWWWWWWWWWWW