WWWWWWWWWWWWWWWWWWWWWWWWWWWWWWWWWWWWWWWWWWWWWWWWWWWWWWWWWWWWWWWWWWWWWWWWWWWWWWWWWWWWWWWWWWWWWWWWWWWWWWWWWWWWWWWWWWWWWWWWWWWWWWWWWWWWWWW
W                                                                                                                                     W
W                                                                                                                                     W
W                                                                                                                                     W
W B                                                                                                                                   W
W                                                                                                                                     W
W                                                                                                                                     W
W                                                                                                                                     W
W                                                                                                                                     W
W                                                                  B                                                                  W
W                                                                                                                                     W
W                                                                                                                                     W
W                                                                                                                                     W
W                                                                                                                                     W
W                                                                                                                                     W
W                       WWWWWWWWWW                                                                                                    W
W                                                                                                                                     W
W                                                                                                                                     W
W                                                                                                                                     W
W                                                                                                                                     W
W                                                                                                                                     W
W                                                                                                                                     W
W                                                                                                                                     W
W  X   M                                       K            G              X D                                                        W
W                                                                                                                                     W
W                                                                                                                                     W
W                                       WWWWWWWWWW                                                                                    W
W                                                 WWWWWW                                                                              W
W                                                                                                                                     W
W                  WWWWWWWW                                                                                                           W
W                                                                                                                                     W
W             WWWWWWWWWWWW                                                                                                            W
W                                                                                                                                     W
W                                                                                                                                     W
W                                                                                                                                     W
W                                                                                                                                     W
W                                                                                                                                     W
W                                                                                                                                     W
W                                                                                                                                     W
W                                                                                                                                     W
W                                                                                                                                     W
W                                                                                                                                     W
W                                                                                                                                     W
W                                                                                                                                     W
W                                                                                                                                     W
W                                                                                                                                     W
W                                                                                                                                     W
W                                                                                                                                     W
W                                                                                                                                     W
W                                                                                                                                     W
W                                                                                                                                     W
W                                                                                                                                     W
W                                                                                                                                     W
W                                                                                                                                     W
W                                                                                                                                     W
W                                                                                                                                     W
W                                                                                                                                     W
W                                                                                                                                     W
W                                                                                                                                     W
W                                                                                                                      W              W
WWWWWWWWWWWWWWWWWWWWWWWWWWWWWWWWWWWWWWWWWWWWWWWWWWWWWWWWWWWWWWWWWWWWWWWWWWWWWWWWWWWWWWWWWWWWWWWWWWWWWWWWWWWWWWWWWWWWWWWWWWWWWWWWWWWWWWW
