WWWWWWWWWWWWWWWWWWWWWWWWWWWWWWWWWWWWWWWWWWWWWWWWWWWWWWWWWWWWWWWWWWWWWWWWWWWWWWWWWWWWWWWWWWWWWWWWWWWWWWWWWWWWWWWWWWWWWWWWWWWWWWWWWWWWWWWWWWWWWWWWWWWWWWWWWWWWWWWWWWWWWWWWWWWWWWWWWWWWWWWWWWWWWWWWWWWWWWWWWWWWWWWWWWWWWWWWWWWWWWWWWWWWWWWWWWWWWWWWWWWWWWWWWWWWWWWWWWWWWWWWWWWWWWWWWWWWWWWWWWWWWWWWWWWWWWWWWWWWWWWWWWWWWWWWWWWWWWWW
W                                                                                                                                                                                                                                                                                                                              W
W                                                                                                                                                                                                                                                                                                                              W
W                                                                                                                                                                                                                                                                                                                              W
W                                                                                                                                                                                                                                                                                                                              W
W                                           B                                                                                                                                                                                                                                                                                  W
W                                                                                                                                                                                                                                                                                                                              W
W                                                                                                                                                                                                                                                                                                                              W
W                                                                                                                                                                                                                                                                                                                              W
W                                                                                                                                                                                                                                                                                                                              W
W                                                                                                                                                                                                                                                                                                                              W
W                                                                                                                                                                                                                                                                                                                              W
W                                                                                                                                                                                                                                                                                                                              W
W                                                                                                                                                                                                                                                                                                                              W
W                                                                                                                                                                                                                                                                                                                              W
W                                                                                                                                                                                                                                                                                                                              W
W                                                                                                                                                                                                                                                                                                                              W
W                                                                                                                                                                                                                                                                                                                              W
W                                                                                                                                                                                                                                                                                                                              W
W                                                                                                                                                                                                                                                                                                                              W
W                                                                                                                                                                                                                                                                                                                              W
W                                                                                                                                                                                                                                                                                                                              W
W                                                                                                                                                                                                                                                                                                                              W
W                                                                                                                                                                                                                                                                                                                              W
W                                                                                                                                                                                                                                                                                                                              W
W                                                                                                                                                                                                                                                                                                                              W
W                                                                                                                                                                                                                                           B                                   B                                              W
W                                                                                                      WWWWWWWWWWWWWWWWW                                                                                                                                                                                                       W
W                                                                                                      W               W                                                                                                                                                                                                       W
W                                                                                                      W               W                                                                                                                                                                                                       W
W                                                                                                      W               W                                                WWWWWWWWW                                                                                                                                              W
W                                                                                                      W               W                                                                                                                                                                                                       W
W                                                                                                      W               W                                                                                                                                                                                                       W
W                                                                                                      W               W                             WWWWWWWWWWWWWWW                 WWWWWWWWWWWWWWWWWWWWWWWWWWWW                                                                                                              W
W                                                                                                      W               W                                                                                        W                                                                                                              W
W                                                                                                      W               W                                                                                        W                                                                                                              W
W                                                                                                      W               W                                                                                        W                                                                                                              W
W                                                                                                      W               W                                                                                        W                                                                                                              W
W                                                                                                      W               W                                                                                        W                                                                                                              W
W                                                                                                      W               W                                                                                        W                                                                                                              W
W                                                                                                      W               W                                                                                        W                                                                                                              W
W                                                                                   FFFFFFFFFFFFFFF    W               W                                                                                        W                                                                                                              W
W                                                                                                      W               W                                                                                        W                                                                                                              W
W                                                                    WWWWWWWWWWWWW                     W               W                                                                                        W                                                                                                              W
W   M                                                                                                  W               W                                                                                        W                                                                                                              W
W                                                                                                      W               W                                                                                        W                                                                                                              W
W                                                                                                      W               W                                                      G                                 W                                                                                                D             W
W                                                  X                                                   W               W                                                                                        W                                                                                                              W
W                                     WWWWWWWWWWWWWWWWWWWWWWWWWWWW                                     W               W                                                                                        W                                                                                                              W
W                                                                                                      W               W                                                                                        W                                                                                                              W
W                                                                                                      W               W                                                                                        W                                                                                                              W
W                                                                                                      W               W                                                                                        W                                                                                                              W
W                                                                                                      W               W                                                                                        W                                                                                                              W
W                                                                                                      W               W                                    K                                                   W                                                                                                              W
W                          WWWWWWWWW                                                                   W               W                                                                                        W                                                                                                              W
W                                                                                                      W               W                                                                                        W                                                                                                              W
W                                                                                                      W               W                                                                                        W                                                                                                              W
W                                                                                                      W               W    FFFFFFFFFFFFFFFFFFFF                                                                W                                                                                                              W
W                                                                                                      W               W                                                                                        W                                                                                                              W
W                                                                                                      W               W                                                                                        W                                      X                                  X                                    W
WWWWWWWWWWWWWWWWWWWWWWWWWWWWWWWWWWWWWWWWWWWWWWWWWWWWWWWWWWWWWWWWWWWWWWWWWWWWWWWWWWWWWWWWWWWWWWWWWWWWWWWWWWWWWWWWWWWWWWWWWWWWWWWWWWWWWWWWWWWWWWWWWWWWWWWWWWWWWWWWWWWWWWWWWWWWWWWWWWWWWWWWWWWWWWWWWWWWWWWWWWWWWWWWWWWWWWWWWWWWWWWWWWWWWWWWWWWWWWWWWWWWWWWWWWWWWWWWWWWWWWWWWWWWWWWWWWWWWWWWWWWWWWWWWWWWWWWWWWWWWWWWWWWWWWWWWWWWWWWW