WWWWWWWWWWWWWWWWWWWWWWWWWWWWWWWWWWWWWWWWWWWWWWWWWWWWWWWWWWWWWWWWWWWWWWWWWWWWWWW
W                                                                             W
W              K                                                              W
W                                                                             W
W                                                                             W
W                                                                             W
W                                                                             W
W                                                                             W
W                                                                             W
W                                                                             W
W                                                                             W
W                                                                             W
W                                                                             W
W                                                                             W
W                                                                             W
W                     B                                                       W
W                                                                             W
W                                                                             W
W                                                                             W
W                                                                             W
W                                                                             W
W                                                          G                  W
W                                                                             W
W  X   M                                                                      W
W                                                                             W
W                                                                             W
W                                                                             W
W                                                                             W
W                                                                             W
W                                                                             W
W                                                    K                       DW
WWWWWWWWWWWWWWWWWWWWWWWWWWWWWWWWWWWWWWWWWWWWWWWWWWWWWWWWWWWWWWWWWWWWWWWWWWWWWWW