WWWWWWWWWWWWWWWWWWWWWWWWWWWWWWWWWWWWWWWWWWWWWWWWWWWWWWWWWWWWWWWWWWWWWWWWWWWWWWW
W                                                                             W
W                                                                             W
W                                                                             W
W                                                                             W
W                                                                             W
W                                                                             W
W        B                                                                    W
W                                                                             W
W                                                                          B  W
W                                                                             W
W                                                                             W
W                                                                             W
W                                                                             W
W                                                                             W
W                                                                             W
W                                                                             W
W                                                                             W
W                                                                             W
W                                                                             W
W                                                                             W
W                                                                             W
W                                                                             W
W  X   M                                       K            G              X DW
W                                                                             W
W                                                                             W
W                                                                             W
W                                                                             W
W                                                                             W
W                                                                             W
W                                                                             W
WWWWWWWWWWWWWWWWWWWWWWWWWWWWWWWWWWWWWWWWWWWWWWWWWWWWWWWWWWWWWWWWWWWWWWWWWWWWWWW
