WWWWWWWWWWWWWWWWWWWWWWWWWWWWWWWWWWWWWWWWWWWWWWW
W                                             W
W              K                              W
W                                             W
W      M                                      W
W                  P                          W
W                                             W
W                                             W
W                       B                     W
W                W                G           W
WWWWWWWWWWWWWWWWWWWWWWWWWWWWWWWWWWWWWWWWWWWWWWW