WWWWWWWWWWWWWWWWWWWWWWWWWWWWWWWWWWWWWWWWWWWWWWW
W                                             W
W                                             W
W                                             W
W                                             W
W                                             W
W                                             W
W                                             W
W                                             W
W       M                                     W
WWWWWWWWWWWWWWWWWWWWWWWWWWWWWWWWWWWWWWWWWWWWWWW