WWWWWWWWWWWWWWWWWWWWWWWWWWWWWWWWWWWWWWWWWWWWWWWWWWWWWWWWWWWWWWWWWWWWWWWWWWWWWWWWWWWWWWWWWWWWWWWWWWWWWWWWWWWWWWWWWWWWWWWWWWWWWWWWWWWWWWWWWWWWWWWWWWWWWWWWWWWWWWWWWWWWWWWWWWWWWWWWWWWWWWWWWWWWWWWWWWWWWWWWWWWWWWWWWWWWWWWWWWWWWWWWWWWWWWWWWWWWWWWWWWWWWWWWWWWWWWWWWWWWWWWWWWWWWWWWWWWWWWWWWWWWWWWWWWWWWWWWWWWWWWWWWWWWWWWWWWWWWWWW
W                          B                                                                                                                                                                                               W                                                                                                   W
W                                                                                                                                                                                                                          W                                                                                      D            W
W                                                                                                                                                                                                                          W                                                                                                   W
W                                                                                                                                                                                            G                             W                                                                                                   W
W                                                                                                                                                                                                                          W                                                                                                   W
W                                                                                                                                                                                                                          W                                                                                                   W
W                                                                                                                                                                                                                          W                                                                                                   W
W                                                                                                                                                                                                                          W                                                                                                   W
W                                                                                                                                                                                                                          W                                                                                                   W
W                                                                                                                                                                                                                          W                                                                                                   W
W                                                                                                                                                                                                                          W                                                                                                   W
W                                                                                                                                                                                                                          W                                                                                                   W
W                                                                                                                                                                                                                          W                                                                                                   W
W                                                                                                                                                                                                                          W                                                                                                   W
W                                                                                                                                                                                                                          W                                                                                                   W
W                                                                                                                                                                                                                          W                             WWWWWWWWWWWWWWWWWWWWWWWWWWWWWWWWWWWWWWWWWWWWWWWWWWWWWWWWWWWWWWWWWWWWWWW
W                                                                                                                                                                                                                          W                                                                                                   W
W                                                                                                   WWWWWWWWWWWWWWWWWWWWWWWWWWWWWWWWWWWWWWWWWWWWWWWWWWWWWWWWW                       WWWWWWWWWWWWWWWWWWWWWWWWWWWWWWWWWWWWWWWW                                                                                                   W
W                                                                                                   W    W                                                                                                                 W                                                                                                   W
W                                                                                                   W    W                                                                                                                 W                                                                                                   W
W                                                                                          WWWWWWWWWW    W                                                                                                                 W                                                                                                   W
W                                                                                          W             W                                                                                                                 W                                                                                                   W
W                                                                                          W             W                                                                                                                 W                                                                                                   W
W                                                                                 WWWWWWWWWW             W                                                                                                                 W                                                B                                                  W
W                                                                                 W                      W                                                                                                                 W                                                                                                   W
W                                                                                 W                      W                                                                                                                 W                                                                                                   W
W                                                                        WWWWWWWWWW                      W                                                        G                                                        W                                                                                                   W
W                                                                        W                               W                                                                                                                 W                                                                                                   W
W                                                                        W                               W                                                                                                                 W                                                                                                   W
W                                                               WWWWWWWWWW                               W                                                                                                                 W                                                                                                   W
W                                                               W                                        W                                                                                                                 W                                                                                                   W
W                                                               W                                        W                                                                                                                 W                                                                                                   W
W                                                      WWWWWWWWWW                                        W                                                                                                                 W                                                                                                   W
W                                                      W                                                 W                                                                                                                 W                                                                                                   W
W                                    X                 W                                                 W                                                                                                                 W                                                                                                   W
W                     WWWWWWWWWWWWWWWWWWWWWWWWWWWWWWWWWW                                                 W                                                                                                                 W                                                                                                   W
W                                                                                                        W                                                                                                                 W        FFFFFFFFFFFFFF                                                                             W
W                                                                                                        W                                                                                                                 W                          WWWWWWWWWWWWWWWWWWWWWWWWWWW         WWWWWWWWWWWWWW                       W
W                                                                                                        W                                                                                                                 W                                                                                                   W
W                                                                                                        W                                                                                                                 W                                                                                                   W
W                                                                                                        W                   WWWWWWWWWWWWWWWWWWWWWWWWWWWWWWWWWWWWWWWWWWWWWWWWWWWWWWWWWWWWWWWWWWWWWWWW                      W                                                                                                   W
W                                                                                M                       W                                                                                                                 W                                                                                                   W
W                                                                                                        W                                                                                                                 W                                                                                                   W
W                                                                                                        W                                                                                                                 W                                                                                                   W
W                                                                                                        W                                                                                                                                                                                                                     W
W                                                                                                        W                                                                                                                                                                                                                     W
W                                                                                                        W                                                                                                                                                                                                                     W
W                                                                                                        W                                                                                                                                                                                                                     W
W                                                                                                        W                                                                                                                                                                                                                     W
W                                                                                                        W                                                                                                                                                                                                                     W
W                                                                                                        W                                                                                                                                                                                                                     W
W                                                                                                        W                                                                                                                                                                                                                     W
W                                                                                                        W                                                                                                                                        K                                                                            W
W                                                                                                        W                                                                                                                                                                                                                     W
W                                                                                                        W                                                                                                                                                                                                                     W
W                                                                                                        W                                                                                                                                                                                                                     W
W   FFFFFFFFFFFFFF                                                                                       W                                                                                                                                                                                                                     W
W                     WWWWWWWWWWWWWWWWWWWW                                                               W                                                                                                                                                                                                     FFFFFFFFFFFFFF  W
W                     WWWWWWWWWWWWWWWWWWWW                                                               W                                                                                                                                                                            X                     W                  W
WWWWWWWWWWWWWWWWWWWWWWWWWWWWWWWWWWWWWWWWWWWWWWWWWWWWWWWWWWWWWWWWWWWWWWWWWWWWWWWWWWWWWWWWWWWWWWWWWWWWWWWWWWWWWWWWWWWWWWWWWWWWWWWWWWWWWWWWWWWWWWWWWWWWWWWWWWWWWWWWWWWWWWWWWWWWWWWWWWWWWWWWWWWWWWWWWWWWWWWWWWWWWWWWWWWWWWWWWWWWWWWWWWWWWWWWWWWWWWWWWWWWWWWWWWWWWWWWWWWWWWWWWWWWWWWWWWWWWWWWWWWWWWWWWWWWWWWWWWWWWWWWWWWWWWWWWWWWWWWW