WWWWWWWWWWWWWWWWWWWWWWWWWWWWWWWWWWWWWWWWWWWWWWWWWWWWWWWWWWWWWWWWWWWWWWWWWWWWWWWWWWWWWWWW
W                                                                                      W
W              K                                                                       W
W                                                                                      W
W                                                                                      W
W                                                                                      W
W                                                                                      W
W                                                                                      W
W                                                                                      W
W                                                                                      W
W                                                                                      W
W                                                                                      W
W                                                                                      W
W                                                  G                                   W
W                                                                                      W
W                     B                                                                W
W                                                                                      W
W                                                                                      W
W                                                                                      W
W                                                                                      W
W                                                                                      W
W                                                          G                           W
W                                                                                      W
W      M                        WWWWWWWW                                               W
W                                                                                      W
W                                             WWWWWWWWWWWWWWWW                         W
W                                                 WWWW                                 W
W                                                                                      W
W                       WWWWWW                                                         W
W                 WWWWWWWWWWWW                                                         W
W           WWWWWWWWWWWWWWWWWW                                                         W
WWWWWWWWWWWWWWWWWWWWWWWWWWWWWWWWWWWWWWWWWWWWWWWWWWWWWWWWWWWWWWWWWWWWWWWWWWWWWWWWWWWWWWWW