WWWWWWWWWWWWWWWWWWWWWWWWWWWWWWWWWWWWWWWWWWWWWWWWWWWWWWWWWWWWWWWWWWWWWWWWWWWWWWW
W                                                                             W
W                                                                             W
W                                                                             W
W B                                                                           W
W                                                                             W
W                                                                             W
W                                                                             W
W                                                                             W
W                                                                          B  W
W                                                                             W
W                                                                             W
W                                                                             W
W                                                                             W
W                                                                             W
W                                                                             W
W                                                                             W
W                                                                             W
W                                                                             W
W                                                                             W
W                                                                             W
W                                                                             W
W                                                                             W
W  X   M                                       K            G              X DW
W                                                                             W
W                                                                             W
W                                       WWWWWWWWWW                            W
W                                                 WWWWWW                      W
W                                                                             W
W                  WWWWWWWW                                                   W
W              WWWWWWWWWWWW                                                   W
WWWWWWWWWWWWWWWWWWWWWWWWWWWWWWWWWWWWWWWWWWWWWWWWWWWWWWWWWWWWWWWWWWWWWWWWWWWWWWW